1111111111
1000000131
1011111101
1010000001
1011100001
1000000001
1010101001
1110101111
1200100001
1111111111